.............
..............
....#....#....
.....#..#.....
.#..........#.
.#..........#.
.....#..#.....
....#....#....
..............
