.............
..............
....##..##....
..............
.#..........#.
.#..........#.
..............
....##..##....
..............
