.............
..............
....######....
....#....#....
....#....#....
....#....#....
....#....#....
....######....
..............
