..####..#####..
...............
#...######....#
#...#....#....#
#...#....#....#
#...#....#....#
#...#....#....#
#...######....#
...............
..####..#####..
