....#..........
...#.#.........
....#..........
..........#....
.........#.#...
..........#....
......#........
.....#.#.......
......#........
...............
