...............
...............
.....ready.....
...............
###############
.......#.......
.......#.......
.ready.#.ready.
.......#.......
.......#.......
